{
  "width": 10,
  "height": 10,
  "character_x": 1,
  "character_y": 1,
  "tilemap": [
    {
      "name": "background",
      "values": [
        [ 89, 89, 89, 89, 89, 89, 89, 89, 89, 89 ],
        [ 89, 89, 89, 89, 89, 89, 89, 89, 89, 89 ],
        [ 89, 89, 89, 89, 89, 89, 89, 89, 89, 89 ],
        [ 89, 89, 89, 89, 89, 89, 89, 89, 89, 89 ],
        [ 89, 89, 89, 89, 89, 89, 89, 89, 89, 89 ],
        [ 89, 89, 89, 89, 89, 89, 89, 89, 89, 89 ],
        [ 89, 89, 89, 89, 89, 89, 89, 89, 89, 89 ],
        [ 89, 89, 89, 89, 89, 89, 89, 89, 89, 89 ],
        [ 89, 89, 89, 89, 89, 89, 89, 89, 89, 89 ],
        [ 89, 89, 89, 89, 89, 89, 89, 89, 89, 89 ]
      ]
    },
    {
      "name": "walls",
      "values": [
        [  87,  87,  87,  87,  87,  87,  87,  87,  87,  87 ],
        [  87,  0,  0,  0,  0,  87,  0,  0,  0,  87 ],
        [  87,  0,  87, 87,  0,  87,  0,  87,  0,  87 ],
        [  87,  0,  0,  87,  0,  0,  0,  87,  0,  87 ],
        [  87,  87, 0,  0,  0,  87,  0,  87,  0,  87 ],
        [  87,  0,  0,  87,  0,  87,  0,  0,  0,  87 ],
        [  87,  0,  87,  87,  87,  87,  87,  87,  0,  87 ],
        [  87,  0,  87,  0,  0,  0,  87,  0,  0,  87 ],
        [  87,  0,  0,  0,  87,  0,  0,  0,  0,  87 ],
        [  87,  87,  87,  87,  87,  87,  87,  87,  87,  87 ]
      ]
    },
    {
      "name": "breakable",
      "values": [
        [   0,   0,   0,   0,   0,   0,   0,   0,   0,   0 ],
        [   0,    0,   0,   4,   4,   0,   4,   0,   4,   0 ],
        [   0,   0,   0,  0,   0,   0,   4,   0,   3,   0 ],
        [   0,   4,   0,   0,   4,   4,   0,   0,   0,   0 ],
        [   0,   0,  4,   0,   0,   0,   4,   0,   4,   0 ],
        [   0,   4,   4,   0,   4,   0,   4,   4,   0,   0 ],
        [   0,   3,   0,   0,   0,   0,   0,   0,   3,   0 ],
        [   0,   0,   0,   4,   0,   0,   0,   4,   4,   0 ],
        [   0,   4,   4,   0,   0,   4,   3,   4,   0,   0 ],
        [   0,   0,   0,   0,   0,   0,   0,   0,   0,   0 ]
      ]
    }
  ],
  "pathing": [
    [  0,  0,  0,  0,  0,  0,  0,  0,  0,  0 ],
    [  0,  1,  1,  1,  1,  0,  1,  1,  1,  0 ],
    [  0,  1,  0, 0,  1,  0,  1,  0,  1,  0 ],
    [  0,  1,  1,  0,  1,  1,  1,  0,  1,  0 ],
    [  0,  0, 1,  1,  1,  0,  1,  0,  1,  0 ],
    [  0,  1,  1,  0,  1,  0,  1,  1,  1,  0 ],
    [  0,  1,  0,  0,  0,  0,  0,  0,  1,  0 ],
    [  0,  1,  0,  1,  1,  1,  0,  1,  1,  0 ],
    [  0,  1,  1,  1,  0,  1,  1,  1,  1,  0 ],
    [  0,  0,  0,  0,  0,  0,  0,  0,  0,  0 ]
  ]
}
      
      